
NO ../42_cubed/pngfiles/blue_flare.png
SO pngfiles/stonewall.png
WE pngfiles/west.png
EA pngfiles/east.png

F 255,100,      200
C 254,255,255

        11111 1111111111111111111
        10001 10001110000000121001
        1011010001111000000100001
        1001000000000000010000001
11111111101100000111000002000001
100000000011000001110000010000001
111111111111111111111001210000001
111111111111111111111012000000001
111101112111110111000011000000001
111101111111100111010110000011111
11000000110101011 12000N010001
10000001000000001 110000010101
1111111 1111111111111111111 11
