
NO ../42_cubed/pngfiles/crystalwall.png
SO pngfiles/facewall.png
WE pngfiles/metalwall.png
EA pngfiles/brickwall.png


F 220,100,0
C 225,30,0

         1111
         1001
         1001
         1001
         1001
1111111111001111111111
1000200000N00000020001
1111111211111121111111
    10000000000001
    10000000000001
    10000000000001
    11000000000011
     110000000011
      1100000011
       11000011
        110011
         1211
     111110011111
     10000000000111111
     10000000000100001
     10000000000200001
     10000000000100001
     11111111111112111
                 101
                 101
                 101
                 101
                 101
                 101
                 101111111111
                 100000000001
                 100000000001
                 100000000001
                 111111111111
  
