
NO ../42_cubed/pngfiles/crystalwall.png
SO pngfiles/facewall.png
WE pngfiles/metalwall.png
EA pngfiles/brickwall.png

F 200,200,      200
C 0,0,200

111111111111  111111111111
10000000000111100000000001
10000000000200200000000001  1 1
100000000001001000000000011121
11111211111100111112111111 101 
   10000000000000000001  1111
   1000001000W000000001  1  1
11111121111100111112111111
10000000000100100000000001
100000000001001000000000011
100000000001001000000000011
100000000002002000000000011
10000000000100100000000001
10000000000111100000000001
111111111111  111111111111