
NO ../42_cubed/pngfiles/crystalwall.png
SO pngfiles/facewall.png
WE pngfiles/metalwall.png
EA pngfiles/brickwall.png

F 255,240,      200
C 254,255,255

111111111111  111111111111
10000000000111100000000001
10000000000200200000000001
10000000000100100000000001
11111211111100111112111111
   10000000000000000001
   1000000000N000000001
11111121111100111112111111
10000000000100100000000001
10000000000100100000000001
10000000000100100000000001
10000000000200200000000001
10000000000100100000000001
10000000000111100000000001
111111111111  111111111111
