
NO ../42_cubed/pngfiles/crystalwall.png
SO pngfiles/facewall.png
WE pngfiles/metalwall.png
EA pngfiles/brickwall.png

F 200,200,255
C 0,0,200


111111111111          111111111111
1000000000011111111111100000000001
1000000000020020000000000111111111
10000000000100100000000001
11111211111100111112111111
   100000000000000000011
   1000000000N000000001
11111121111100111112111111
10000000000100100000000001
100001000001001000000000011
100002000001001000000000011
100001000002002000000000011
10000000000100100000000001
10000000000111100000000001
111111111111  111111111111



