
NO ../42_cubed/pngfiles/blue_flare.png
SO pngfiles/stonewall.png
WE pngfiles/west.png
EA pngfiles/east.png

F 255,100,      200
C 254,255,255

        11111 1111111111111111111
        10001 10001112000200000001
        1011010001111202002100001
        1001000000000000000000001
1111111110110000011100000N0000001
100000000011000001110000000000001
111111111111111111111000000000001
111111111111111111111000000000001
111101111111110111000000000000001
111101111111100111010100100011111
11000000110101011 100000010001
10000001000000001 100000010101
1111111 1111111111111111111 11
