
NO ../42_cubed/pngfiles/blue_flare.png
SO pngfiles/stonewall.png
WE pngfiles/west.png
EA pngfiles/east.png

F 255,100,      200
C 254,255,255

        11111 1111111111111111111
        10001 1000110000000000001
        101101000111000000000001
        10010000000000000N0000001
111111111011000001110000000000001
100000000011000001110111111111111
1111111111111111111111111
11111111111111111111111111111
11110111111111011100000010001
11110111111110011101010010001
11000000110101011 100000010001
10000001000000001 100000010101
1111111 1111111111111111111 11