
NO ./path_to_the_north_texture
SO      ./path_to_the_south_texture
WE  ./path_to_the_west_texture
EA    ./path_to_the_east_texture

F 255,100,      200           
C 254,255,255

        11111 1111111111111111111
        10001 1000110000000000001
        1011010001110000000000001
        1001000000000000000000001
111111111011000001110000000000001
100000000011000001110111111111111
11110111111111011100000010001
11110111111110011101010010001
11000000110101011 100000010001
10000001000000001 1000000101N1
1111111 1111111111111111111 11
